4 4 4 4 4 4 4 4 4 4 4 4 4 4 4 4 4 4 4 4 4 4 4 4 4 4 4 4 4 4 4 4 4 4 4 4 4 4 4 4 4 4 4 4 4 4 4 4 4 4
4 0 0 12 8 0 0 0 0 0 0 0 0 0 8 0 0 0 0 0 0 0 0 0 8 0 0 0 0 0 0 0 0 0 0 0 0 0 8 8 8 0 0 0 0 0 0 0 0 4
4 0 0 0 8 8 8 8 8 0 8 8 8 8 8 0 0 11 0 0 0 0 0 0 8 0 0 0 0 0 0 0 0 0 0 0 0 0 0 8 0 0 0 0 0 0 0 0 0 4
4 0 0 0 0 0 8 0 0 0 0 0 0 12 8 0 0 0 0 8 8 8 8 8 8 0 0 0 0 0 0 0 0 0 0 0 0 0 0 0 0 0 0 0 0 0 0 0 0 4
4 8 8 8 0 8 8 0 0 8 8 8 8 8 8 0 0 0 5 0 0 0 0 0 0 0 0 0 0 8 0 0 0 0 0 0 0 0 0 0 0 0 0 0 0 0 0 0 8 4
4 0 0 8 0 0 8 0 5 0 8 0 0 0 0 0 8 0 0 0 0 0 0 0 0 0 0 0 8 8 8 0 0 0 0 0 0 0 0 0 0 0 0 0 0 0 0 8 8 4
4 0 0 0 0 0 0 0 0 0 8 0 0 11 0 0 8 8 8 8 8 8 8 8 8 0 0 0 0 8 0 0 0 0 0 0 0 0 0 0 0 0 0 0 0 0 0 0 8 4
4 0 0 8 8 8 8 8 0 0 8 0 0 0 0 0 8 0 0 0 0 0 0 0 8 0 0 0 0 0 0 0 0 0 11 0 0 0 0 0 0 0 0 0 0 0 0 0 0 4
4 0 0 8 12 0 0 0 0 0 8 0 0 8 0 0 0 0 0 0 0 0 0 0 8 0 0 0 0 0 0 0 0 0 0 0 0 0 0 0 0 0 0 8 0 0 0 0 0 4
4 0 8 8 0 0 0 0 0 0 8 0 0 8 8 8 8 8 0 0 8 8 12 0 8 0 0 0 0 0 0 0 0 0 0 0 0 0 0 0 0 0 8 8 8 0 0 0 0 4
4 0 0 8 0 0 8 8 0 0 0 0 0 0 12 8 0 5 0 0 8 8 0 0 8 0 0 0 0 0 0 0 0 0 0 0 0 0 0 0 0 0 0 8 0 0 0 0 0 4
13 8 8 8 0 0 0 0 0 0 0 8 0 0 0 0 0 0 0 0 8 0 0 0 8 0 0 0 0 0 0 0 0 0 0 0 0 0 0 0 0 0 0 0 0 0 0 0 0 4
9 0 0 0 0 0 0 0 11 0 0 8 0 0 0 0 0 0 0 0 8 0 0 0 8 0 0 0 5 0 0 0 0 0 0 0 8 0 0 0 0 0 0 0 0 0 0 0 13 4
9 0 0 0 0 5 0 0 0 0 0 8 0 0 0 0 8 0 0 0 0 0 0 0 8 0 0 0 0 0 0 0 0 0 0 8 8 8 0 0 0 0 0 0 0 0 0 0 0 9
13 8 8 8 8 8 8 8 8 0 0 8 0 0 0 0 8 0 0 0 0 0 8 0 8 0 0 0 0 0 0 0 0 0 0 0 8 0 0 0 0 0 0 0 0 0 0 0 13 4
4 0 0 0 0 8 0 0 0 0 0 0 0 0 0 0 8 0 0 0 0 0 8 0 8 0 0 0 0 0 0 0 0 0 0 0 0 0 0 0 8 0 0 0 0 0 0 0 0 4
4 0 0 0 0 8 0 0 0 0 0 0 0 0 8 8 8 0 0 5 0 0 8 8 8 0 0 0 8 0 0 0 0 0 0 0 0 0 0 8 8 8 0 0 0 0 0 0 0 4
4 0 0 8 8 8 0 0 12 8 0 0 0 0 0 0 8 8 0 0 0 0 0 0 8 0 0 8 8 8 0 0 0 11 0 0 0 0 0 0 8 0 0 0 0 0 0 0 0 4
4 0 0 8 0 0 0 0 8 8 8 0 0 0 8 8 8 0 0 0 8 8 0 0 8 0 0 0 8 0 0 0 0 0 0 0 0 0 0 0 0 0 0 11 0 0 0 0 0 4
4 0 0 8 0 0 0 0 0 8 0 0 0 0 0 8 0 0 0 8 8 12 0 0 8 0 0 0 0 0 0 0 0 0 0 0 0 0 0 0 0 0 0 0 0 0 0 0 0 4
4 0 8 8 8 8 0 5 0 8 8 0 0 0 8 8 0 0 5 0 8 8 0 0 8 0 0 0 0 0 0 0 0 0 0 0 0 0 0 0 0 0 0 0 0 0 0 0 0 4
4 0 0 0 0 8 0 0 0 0 8 8 0 0 0 8 8 0 0 0 8 0 0 8 8 0 0 0 0 0 0 0 0 0 0 0 0 0 0 0 0 0 0 0 0 0 0 0 0 4
4 8 8 0 0 0 11 0 0 0 8 0 0 0 0 0 8 8 0 0 0 0 0 0 8 0 0 0 8 0 0 0 0 0 0 0 0 0 0 0 0 0 0 0 0 0 0 0 0 4
4 12 0 0 0 0 0 0 0 0 0 0 0 0 0 0 0 0 0 0 0 0 0 12 8 0 0 8 8 8 0 0 0 0 0 0 0 0 0 0 0 0 0 0 0 0 0 0 0 4
4 4 4 4 4 4 4 4 4 4 4 4 4 4 4 4 4 4 4 4 4 4 4 4 4 4 4 4 4 4 4 4 4 4 4 4 4 4 4 4 4 4 4 4 4 4 4 4 4 4